8 8
xxxxxxxx
x0x00000
x00xx00x
x0x0x00x
x000x00x
x0x000xx
x000x00x
xxxxxxxx