10 10
xxxxxxxxxx
x0000xx000
x0x000x00x
x000000x0x
x0x00x000x
x00xx00x0x
x000000xxx
xx00x0x00x
xx0x0xxxxx
xxxxxxxxxx
