20 20
xxxxxxxxxxxxxxxxxxxx
x00000000xxx0x00xx00
x0x000x0x0x0x0xx0x0x
x0x0x0x0x0000000000x
x000x000x0000000000x
x0xx0x000x000x00000x
x00x0xxx000x00000xxx
x0000000000x00x000xx
x00000000xx00xx0xx0x
xx0x00x000000x0xx0xx
x0000000x0000x000xxx
x0000000x0x0000x00xx
x00xxxx0000x00x00x0x
xxx0xxx0xx000x0x000x
x0000000x000x000x00x
xxx00x000x000x00000x
x00x0x0x0x00000xx0xx
x00x000x0000x000x0xx
xxx00x0000x00000000x
xxxxxxxxxxxxxxxxxxxx
